UUUUUUUU
U   RRUU
U UUUUUU
U    6 U
U   5  U
U 5 6  U
U5 5  6U